mochi = nigiri (okinawa vs japans)

Onderdelen:
- Saki: Punt
- Monouchi: Schacht
- Yoku: Zijstang
- Moto: basis van de zijstang
- Tsume: Punt van de zijstang
- Tsuka: Greep
- Tsukagashira: Achterkant (Pommel)

Grepen:
- Honte mochi: normale greep
- Gyakute mochi: omgedraaide greep
- Tokushu mochi: speciale greep
- Mochikae: van greep wisselen
- Kakushi buki: verbergen

Uke:
? Hiraki: open block
? soto: outside
? uchi: inside
- jodan uke  (gyakute mochi): upper
- gedan uke (gyakute mochi): lower
- chudan harai (honte mochi): ronde veeg van binnen naar buiten
- gedan harai (honte mochi): ronde veeg van binnen naar buiten
- jodan harai (honte mochi): ronde veeg van binnen naar buiten
- juji uke (morote honte mochi): gekruiste blok

Seme:
(Saki|Honte Mochi) Tsuki – Natural Grip (tip) Thrust
(Tsukagashira|Gyakute Mochi) Tsuki – Reverse Grip (butt) Thrust
(Tsume|Honte mochi ) Nodo tsuki: stoot naar keel

Kaeshi Uchi: slag waarbij de pols draait
Jodan mawashi uchi: ronde slag naar het hoofd
  - Yoko: horizontaal
  - Nanami: diagonaal
Kote uchi: slag naar de pols
Nikkai kote uchi: 2 slagen naar pols aan beide kanten